8 7
------H-
------H-
------H-
H‾‾‾‾‾H-
H-----H-
========
XXXXXXXX
0 2
5 2 7 6
7 2