8 6
--------
--------
--===H--
-----H--
-----H--
XXXXXXXX
0 1
4 1 7 1 2 4