18 16
------------------
H=====H-----------
H-----H----H=====-
H=====H----H------
H-----H‾‾‾‾H‾‾‾‾‾-
H-----H----H----H-
H-----H----H----H-
H-----H----HXXXXX-
H-----H----H------
===========H------
======-----H------
=----=-----H------
========H======---
--------H---------
--------H---------
XXXXXXXXXXXXXXXXXX
0 1
10 1 8 7 14 9 2 13 15 14
17 1 17 15 