8 6
------H-
------H-
------H-
H‾‾‾‾‾H-
H-----H-
XXXXXXXX