8 6
------H-
------H-
------H-
H‾‾‾‾‾H-
H-----H-
XXXXXXXX
0 1
5 1 7 5
7 1