21 10
---------------------
---H=============H---
---H-------------H---
---H-------------H---
=====H---------H=====
-----H---------H-----
-----H---------H-----
-----H---------H-----
=====================
XXXXXXXXXXXXXXXXXXXXX
10 2
10 9 0 6 20 6 1 2 19 2
0 2 20 2