8 7
--------
--------
--===H--
-----H--
-----H--
=====H==
XXXXXXXX
0 2
4 2 7 2 2 5