18 7
------------------
=================H
-----------------H
H=================
H-----------------
==================
XXXXXXXXXXXXXXXXXX
0 2
1 4 15 2 0 6 17 2
16 2